敌空空空空空空空空空空空敌
空砖空砖空砖空砖空砖空砖空
空铁空铁空铁空铁空铁空铁空
敌砖空砖空砖空砖空砖空砖空
空铁空铁空铁空铁空铁空铁敌
空空空空空空空空空空空空空
铁空水水空空铁空空水水空铁
草草草草草砖草砖草草草草草
空砖空砖空砖空砖空砖空砖空
空砖空砖空砖空砖空砖空砖空
空砖空砖空空空空空砖空砖空
空空空空空空空空空空空空空
空空空空空空空空空空空空空